001 123 150 038 039 150 123 257 259 259 259 261 123 038 039 123 028 145 145 145 145 145 145 145 145 068 071 071 071 071 071 071 067 005 005 040 040 005 002
006 124 000 000 000 000 124 258 260 260 260 262 124 000 000 124 006 189 172 188 172 147 147 168 169 072 078 078 078 078 078 098 074 000 054 035 000 000 006
248 000 056 041 000 000 000 055 041 056 181 118 077 076 000 054 090 143 154 138 154 181 118 170 171 075 097 078 078 078 098 074 000 205 000 000 000 041 006
249 000 000 001 092 093 144 252 109 151 151 110 253 081 076 041 091 056 000 000 000 000 000 000 100 104 072 078 078 078 265 000 000 206 181 118 077 071 094
250 000 000 227 182 182 000 075 097 078 078 078 078 078 073 000 003 005 005 005 005 005 002 102 101 105 072 078 078 078 247 056 000 077 221 220 080 078 073
248 041 000 228 168 169 041 000 075 086 087 070 097 098 074 054 000 000 000 000 000 000 227 041 000 077 080 078 078 078 246 041 000 072 078 078 078 078 073
249 055 270 003 264 263 076 056 054 000 000 000 075 095 056 000 077 221 220 071 076 000 228 000 056 072 078 078 078 078 265 000 000 075 070 097 078 078 073
006 056 269 162 072 078 073 041 054 175 203 000 000 090 041 000 072 078 078 078 247 000 003 092 093 066 232 232 232 070 074 000 054 100 104 072 078 078 073
006 000 181 118 072 078 125 126 256 236 237 076 000 091 000 000 072 078 078 078 246 000 000 054 055 000 172 168 169 000 000 000 102 101 105 075 086 087 095
036 000 267 104 072 078 078 078 078 078 078 096 005 016 000 000 075 097 078 098 074 054 041 000 000 000 154 170 171 000 267 104 077 076 041 000 000 000 006
036 268 266 105 132 086 087 097 078 078 078 073 000 006 000 000 000 072 078 073 056 000 000 000 196 195 000 056 041 268 266 105 072 081 071 076 000 041 006
023 038 039 005 016 000 000 075 271 271 271 074 000 227 000 041 077 080 078 081 076 000 001 145 202 201 092 093 002 000 077 071 080 078 078 073 054 000 006
006 041 000 056 090 000 041 205 137 153 137 000 041 228 054 055 072 078 078 078 073 000 006 168 169 172 000 000 006 000 075 245 242 242 244 074 056 000 006
006 000 000 000 091 000 000 206 138 154 138 000 056 090 056 000 075 070 086 087 074 000 006 170 171 154 041 000 006 041 000 000 000 000 000 205 041 000 006
006 233 175 203 006 175 203 000 179 000 000 192 191 091 041 000 000 000 000 056 000 000 006 000 077 071 076 216 006 192 191 233 196 195 233 206 181 118 006
003 234 174 204 027 174 204 005 005 005 005 190 187 027 005 005 005 005 005 005 005 005 027 005 066 070 069 218 027 190 187 234 194 193 234 255 038 039 004