01 05 05 05 05 28 05 05 05 05 05 05 05 05 05 05 05 05 05 05 05 05 05 05 05 28 05 05 05 05 05 05 05 05 05 05 05 05 02
06 00 00 00 00 06 00 00 00 00 00 00 00 00 00 00 00 00 00 00 00 00 00 00 00 06 00 00 00 00 00 00 00 00 00 00 00 00 06
06 33 00 00 00 06 00 00 27 05 05 05 05 05 05 05 05 05 05 05 05 05 05 05 05 06 00 00 03 05 05 05 05 05 05 05 05 05 06
06 34 00 00 00 06 00 00 00 00 00 00 00 00 00 00 00 00 00 00 00 00 00 00 00 06 00 00 06 00 00 00 00 00 00 00 00 00 06
06 00 00 00 00 06 00 00 00 00 00 00 00 00 00 00 00 00 00 00 00 00 00 00 00 06 00 00 06 00 33 00 00 00 33 00 00 00 06
03 05 05 05 05 04 00 00 01 05 05 05 05 05 05 16 00 00 01 05 05 05 05 05 05 16 00 00 06 00 34 00 00 00 34 00 00 00 06
00 00 00 00 00 00 00 00 06 00 00 00 00 00 00 06 00 00 06 00 00 00 00 00 00 06 00 00 06 00 00 00 00 00 00 00 00 00 06
00 00 00 00 00 00 00 00 06 00 00 00 00 00 00 06 00 00 06 00 00 27 00 00 00 06 00 00 03 05 05 05 05 05 05 05 05 05 16
00 00 00 00 00 00 00 00 06 00 00 27 00 00 00 06 00 00 06 00 00 00 00 00 00 06 00 00 00 00 00 00 00 00 00 00 00 00 06
01 05 05 05 16 00 00 00 06 00 00 00 00 00 00 06 00 00 06 00 00 00 00 00 00 06 00 00 01 05 05 05 05 05 05 05 05 05 06
06 00 00 00 06 00 00 00 03 05 05 05 05 05 05 04 00 00 03 05 05 05 05 05 05 04 00 00 06 00 00 00 33 00 00 00 00 00 06
06 23 00 00 06 00 00 00 00 00 00 00 00 00 00 00 00 00 00 00 00 00 00 00 00 00 00 00 06 00 00 00 34 00 00 00 00 00 06
06 00 00 00 06 00 00 00 00 00 00 17 17 17 17 17 17 17 17 17 17 17 00 00 00 00 00 00 06 00 00 00 00 00 00 00 00 00 06
06 00 00 00 06 00 00 00 00 00 00 17 17 17 17 17 17 17 17 17 17 17 00 00 00 00 00 00 06 00 35 00 00 00 35 00 00 00 06
06 00 00 00 06 00 00 00 00 00 00 00 00 00 00 00 00 00 00 00 00 00 00 00 00 00 00 00 06 00 35 00 00 00 35 00 00 00 06
03 05 05 05 04 00 00 00 03 05 05 05 05 05 27 05 05 05 05 05 05 05 05 05 05 05 05 05 04 00 00 00 00 00 00 00 00 00 00