01 05 05 05 05 05 22 05 05 05 28 05 05 05 05 05 05 05 28 05 05 05 28 05 05 05 05 05 05 05 05 05 05 05 28 05 37 37 04
06 00 00 00 00 00 06 00 00 00 06 00 00 00 00 00 00 00 06 00 00 00 06 00 33 00 33 00 33 00 33 00 33 00 06 00 00 00 06
06 00 00 00 00 00 06 00 00 00 06 00 00 00 00 00 00 00 06 00 00 00 06 00 34 00 34 00 34 00 34 00 34 00 06 00 35 00 06
06 00 00 00 00 00 00 00 00 00 06 00 00 00 00 00 00 00 06 00 00 00 06 00 00 00 00 00 00 00 00 00 00 00 06 00 00 00 06
06 00 00 00 00 00 00 00 00 00 06 00 00 00 00 00 00 00 06 00 00 00 06 00 00 00 00 00 00 00 12 05 05 05 14 00 00 00 06
20 05 05 05 05 05 16 00 00 00 13 05 05 05 05 00 00 05 14 00 00 00 13 05 05 05 05 00 00 05 14 00 00 00 00 00 00 00 06
06 00 00 00 00 00 00 00 00 00 00 00 00 00 00 00 00 00 00 00 00 00 00 00 00 00 00 00 00 00 00 00 00 00 00 00 00 00 06
06 00 00 00 00 00 00 00 00 00 00 00 00 00 00 00 00 00 00 00 00 00 00 00 00 00 00 00 00 00 00 00 00 00 00 00 00 00 16
06 00 00 00 00 00 00 00 00 00 00 00 00 00 00 00 00 00 00 00 00 00 00 00 00 00 00 00 00 00 00 00 00 06 05 05 00 00 06
20 05 05 05 05 05 05 05 05 00 00 05 28 05 00 00 05 05 05 05 05 05 05 05 05 05 05 05 11 00 00 05 05 16 00 00 00 00 06
06 00 00 00 00 00 00 00 00 00 00 00 06 00 00 00 00 00 00 00 00 00 00 00 00 00 00 00 06 00 00 00 00 06 00 00 00 00 06
06 00 00 00 00 00 00 00 00 00 00 00 06 00 00 00 00 00 00 00 00 00 00 00 00 00 00 00 06 00 00 05 05 15 05 05 00 00 06
06 00 00 00 00 00 00 00 00 00 00 00 06 00 00 00 00 00 00 00 00 00 00 00 00 00 00 00 06 00 00 00 00 06 00 00 00 00 06
06 00 00 00 00 00 00 00 00 00 00 00 06 00 00 00 00 00 00 00 00 00 00 00 00 00 00 00 06 00 00 00 00 00 00 00 00 00 06
06 00 00 00 00 00 00 00 00 00 00 00 06 00 00 00 00 00 00 00 00 00 00 00 00 00 00 00 06 00 00 00 00 00 00 00 00 00 06
02 05 05 05 05 05 05 05 05 05 05 05 27 05 05 05 05 05 05 37 37 05 05 05 05 05 05 05 27 05 05 05 05 05 05 05 05 05 03