01 05 05 05 05 05 28 05 05 05 28 05 05 05 05 05 05 05 28 05 05 05 28 05 05 05 05 05 05 05 05 05 05 05 28 05 40 40 02
06 00 00 00 00 00 06 00 00 00 06 00 00 00 00 00 00 00 06 00 00 00 06 00 33 00 33 00 33 00 33 00 33 00 06 00 35 00 06
06 00 00 00 00 00 06 00 00 00 06 00 00 00 00 00 00 00 06 00 00 00 06 00 34 00 34 00 34 00 34 00 34 00 06 00 00 00 06
06 00 00 00 00 00 00 00 00 00 06 00 00 00 00 00 00 00 06 00 00 00 06 00 00 00 00 00 00 00 00 00 00 00 06 00 00 00 06
06 00 00 00 00 00 00 00 00 00 06 00 00 00 00 00 00 00 06 00 00 00 06 00 00 00 00 00 00 00 01 05 05 05 04 00 00 00 06
20 05 05 05 05 05 16 00 00 00 03 05 05 05 05 00 00 05 04 00 00 00 27 05 05 05 05 00 00 05 04 00 00 00 00 00 00 00 06
06 00 00 00 00 00 00 00 00 00 00 00 00 00 00 00 00 00 00 00 00 00 00 00 00 00 00 00 00 00 00 00 00 00 00 00 00 00 06
06 00 00 00 00 00 00 00 00 00 00 00 00 00 00 00 00 00 00 00 00 00 00 00 00 00 00 00 00 00 00 00 00 00 00 00 00 00 16
06 00 00 00 00 00 00 00 00 00 00 00 00 00 00 00 00 00 00 00 00 00 00 00 00 00 00 00 00 00 00 00 00 23 05 05 00 00 06
20 05 05 05 05 05 05 05 05 00 00 05 28 05 00 00 05 05 05 05 05 05 05 05 05 05 05 05 02 00 00 05 05 16 00 00 00 00 06
06 00 00 00 00 00 00 00 00 00 00 00 06 00 00 00 00 00 00 00 00 00 00 00 00 00 00 00 06 00 00 00 00 06 00 00 00 00 06
06 00 00 00 00 00 00 00 00 00 00 00 06 00 00 00 00 00 00 00 00 00 00 00 00 00 00 00 06 00 00 05 05 15 05 05 00 00 06
06 00 00 00 00 00 00 00 00 00 00 00 06 00 00 00 00 00 00 00 00 00 00 00 00 00 00 00 06 00 00 00 00 06 00 00 00 00 06
06 00 00 00 00 00 00 00 00 00 00 00 06 00 00 00 00 00 00 00 00 00 00 00 00 00 00 00 06 00 00 00 00 00 00 00 00 00 06
06 00 00 00 00 00 00 00 00 00 00 00 06 00 00 00 00 00 00 00 00 00 00 00 00 00 00 00 06 00 00 00 00 00 00 00 00 00 06
03 05 05 05 05 05 05 05 05 05 05 05 27 05 05 05 05 05 05 36 36 05 05 05 05 05 05 05 27 05 05 05 05 05 05 05 05 05 03