01 123 38 39 123 150 123 38 39 150 57 59 150 38 39 123 28 145 145 145 145 145 145 145 145 68 71 71 71 71 71 71 67 05 05 40 40 05 02
06 124 00 00 124 00 124 00 00 00 58 60 00 00 00 124 06 189 172 188 172 147 147 168 169 72 78 78 78 78 78 98 74 00 00 35 00 00 06
06 00 00 00 00 00 00 00 00 00 00 00 77 76 00 00 00 143 154 138 154 181 118 170 171 75 97 78 78 78 98 74 00 00 00 00 00 00 06
06 00 00 01 00 00 05 68 71 71 71 71 80 81 76 00 00 00 00 00 00 00 00 00 00 00 72 78 78 78 73 00 00 00 00 00 77 71 94
06 00 00 06 00 00 00 75 97 78 78 78 78 78 73 00 03 05 05 05 05 05 02 00 00 00 72 78 78 78 73 00 00 77 71 71 80 78 73
06 00 00 06 00 00 00 00 75 70 70 70 97 98 74 00 00 00 00 00 00 00 06 00 00 77 80 78 78 78 73 00 00 72 78 78 78 78 73
06 00 00 03 68 71 76 00 00 00 00 00 75 95 00 00 77 71 71 71 76 00 06 00 00 72 78 78 78 78 73 00 00 75 70 97 78 78 73
06 00 00 00 72 78 73 00 00 00 00 00 00 00 00 00 72 78 78 78 73 00 03 00 00 66 70 70 70 70 74 00 00 00 00 72 78 78 73
06 00 00 00 72 78 125 126 126 126 126 136 00 00 00 00 72 78 78 78 73 00 00 00 00 00 00 00 00 00 00 00 00 00 00 75 70 70 95
36 00 00 00 72 78 78 78 78 78 78 96 05 16 00 00 75 97 78 98 74 00 00 00 00 00 00 00 00 00 00 00 77 76 00 00 00 00 06
36 00 00 00 132 70 70 97 78 78 78 73 00 06 00 00 00 72 78 73 00 00 00 00 196 195 00 00 00 00 00 00 72 81 71 76 00 00 06
23 00 00 05 16 00 00 75 145 145 145 74 00 06 00 00 77 80 78 81 76 00 01 145 202 201 00 00 02 00 77 71 80 78 78 73 00 00 06
06 00 00 00 00 00 00 205 137 153 137 00 00 06 00 00 72 78 78 78 73 00 06 168 169 172 00 00 06 00 75 70 70 70 70 74 00 00 06
06 00 00 00 00 00 00 206 138 154 138 00 00 00 00 00 75 70 70 70 74 00 06 170 171 154 00 00 06 00 00 00 00 00 00 00 00 00 06
06 00 00 00 06 00 00 00 179 00 00 192 191 00 00 00 00 00 00 00 00 00 06 00 77 71 76 00 06 00 00 00 00 00 00 00 00 00 06
03 05 05 05 27 05 05 05 05 05 05 190 187 27 05 05 05 05 05 05 05 05 27 05 66 70 69 05 27 05 05 05 05 05 05 05 05 05 04