001 123 038 039 123 150 123 038 039 150 057 059 150 038 039 123 028 145 145 145 145 145 145 145 145 068 071 071 071 071 071 071 067 005 005 040 040 005 002
006 124 000 000 124 000 124 000 000 000 058 060 000 000 000 124 006 189 172 188 172 147 147 168 169 072 078 078 078 078 078 098 074 000 000 035 000 000 006
006 000 000 000 000 000 000 000 000 000 000 000 077 076 000 000 000 143 154 138 154 181 118 170 171 075 097 078 078 078 098 074 000 000 000 000 000 000 006
006 000 000 001 000 000 005 068 071 071 071 071 080 081 076 000 000 000 000 000 000 000 000 000 000 000 072 078 078 078 073 000 000 000 000 000 077 071 094
006 000 000 006 000 000 000 075 097 078 078 078 078 078 073 000 003 005 005 005 005 005 002 000 000 000 072 078 078 078 073 000 000 077 071 071 080 078 073
006 000 000 006 000 000 000 000 075 070 070 070 097 098 074 000 000 000 000 000 000 000 006 000 000 077 080 078 078 078 073 000 000 072 078 078 078 078 073
006 000 000 003 068 071 076 000 000 000 000 000 075 095 000 000 077 071 071 071 076 000 006 000 000 072 078 078 078 078 073 000 000 075 070 097 078 078 073
006 000 000 000 072 078 073 000 000 000 000 000 000 000 000 000 072 078 078 078 073 000 003 000 000 066 070 070 070 070 074 000 000 000 000 072 078 078 073
006 000 000 000 072 078 125 126 126 126 126 136 000 000 000 000 072 078 078 078 073 000 000 000 000 000 000 000 000 000 000 000 000 000 000 075 070 070 095
036 000 000 000 072 078 078 078 078 078 078 096 005 016 000 000 075 097 078 098 074 000 000 000 000 000 000 000 000 000 000 000 077 076 000 000 000 000 006
036 000 000 000 132 070 070 097 078 078 078 073 000 006 000 000 000 072 078 073 000 000 000 000 196 195 000 000 000 000 000 000 072 081 071 076 000 000 006
023 000 000 005 016 000 000 075 145 145 145 074 000 006 000 000 077 080 078 081 076 000 001 145 202 201 000 000 002 000 077 071 080 078 078 073 000 000 006
006 000 000 000 000 000 000 205 137 153 137 000 000 006 000 000 072 078 078 078 073 000 006 168 169 172 000 000 006 000 075 070 070 070 070 074 000 000 006
006 000 000 000 000 000 000 206 138 154 138 000 000 000 000 000 075 070 070 070 074 000 006 170 171 154 000 000 006 000 000 000 000 000 000 000 000 000 006
006 000 000 000 006 000 000 000 179 000 000 192 191 000 000 000 000 000 000 000 000 000 006 000 077 071 076 000 006 000 000 000 000 000 000 000 000 000 006
003 005 005 005 027 005 005 005 005 005 005 190 187 027 005 005 005 005 005 005 005 005 027 005 066 070 069 005 027 005 005 005 005 005 005 005 005 005 004