01 05 05 05 05 05 28 05 05 05 28 05 05 05 05 05 28 05 28 05 05 05 28 05 05 28 05 05 68 71 71 71 67 05 28 40 40 05 02
06 00 00 00 00 00 00 00 00 00 00 00 00 00 00 00 06 00 00 00 00 00 00 00 00 06 00 00 75 97 78 98 74 00 00 35 00 00 06
06 00 00 00 00 00 00 00 00 00 00 00 00 00 00 00 00 00 00 00 00 00 00 00 00 06 00 00 00 75 79 74 00 00 00 00 00 00 06
06 00 00 01 05 05 05 05 05 00 05 05 05 02 00 00 00 00 00 00 00 00 06 00 00 03 05 05 00 00 16 00 00 01 05 05 00 00 16
06 00 00 06 00 00 00 00 00 00 00 00 00 06 00 00 03 05 05 05 05 05 16 00 00 00 00 00 00 00 06 00 00 06 00 00 00 00 06
06 00 00 06 00 00 00 00 00 00 00 00 00 06 00 00 00 00 00 00 00 00 23 05 05 68 71 76 00 00 06 00 00 06 00 00 77 71 94
06 00 00 03 05 05 02 00 00 00 00 00 00 06 00 00 77 71 71 71 76 00 06 00 00 75 97 73 00 00 06 00 00 06 00 00 72 78 73
06 00 00 00 00 00 06 00 00 00 00 00 00 00 00 00 72 78 78 78 73 00 06 00 00 00 75 74 00 00 06 00 00 06 00 00 75 70 95
06 00 00 00 00 00 06 00 00 00 00 00 00 00 00 00 72 78 78 78 73 00 06 00 00 00 00 00 00 00 06 00 00 06 00 00 00 00 06
36 00 00 00 00 00 23 05 05 05 05 05 05 16 00 00 75 70 70 70 75 00 03 05 05 05 05 27 00 00 04 00 00 03 00 00 05 05 16
36 00 00 00 00 00 06 00 00 00 00 00 00 06 00 00 00 00 00 00 00 00 00 00 00 00 00 00 00 00 00 00 00 00 00 00 00 00 06
06 00 00 00 00 00 00 00 00 00 00 00 00 06 00 00 77 71 71 71 76 00 00 00 00 00 00 00 00 00 77 71 71 76 00 00 00 77 94
06 00 00 00 00 00 00 00 00 00 00 00 00 06 00 00 72 78 78 78 73 00 01 05 05 05 05 05 02 00 75 70 70 74 00 00 00 72 73
06 00 00 00 00 00 06 00 00 00 00 00 00 00 00 00 75 70 70 70 74 00 06 00 00 00 00 00 00 00 00 00 00 00 00 00 77 80 73
06 00 00 00 00 00 06 00 00 00 00 00 00 00 00 00 00 00 00 00 00 00 06 00 00 00 00 00 00 00 00 00 00 00 77 71 80 78 73
03 05 05 05 05 05 27 05 05 05 05 05 05 27 05 05 05 05 05 05 05 05 27 05 05 05 05 05 27 05 05 05 05 05 66 70 70 70 74