01 05 05 05 05 05 05 05 05 05 05 05 05 05 05 05 28 05 05 05 05 05 28 05 05 68 71 71 71 71 71 71 67 05 05 40 40 05 02
06 00 00 00 00 00 00 00 00 00 00 00 00 00 00 00 06 00 00 00 00 00 00 00 00 72 78 78 78 78 78 98 74 00 00 35 00 00 06
06 00 00 00 00 00 00 00 00 00 00 00 77 76 00 00 00 00 00 00 00 00 00 00 00 75 97 78 78 78 98 74 00 00 00 00 00 00 06
06 00 00 01 00 00 05 68 71 71 71 71 80 81 76 00 00 00 00 00 00 00 00 00 00 00 72 78 78 78 73 00 00 00 00 00 77 71 94
06 00 00 06 00 00 00 75 97 78 78 78 78 78 73 00 03 05 05 05 05 05 16 00 00 00 72 78 78 78 73 00 00 77 71 71 80 78 73
06 00 00 06 00 00 00 00 75 70 70 70 97 98 74 00 00 00 00 00 00 00 06 00 00 77 80 78 78 78 73 00 00 72 78 78 78 78 73
06 00 00 03 68 71 76 00 00 00 00 00 75 95 00 00 77 71 71 71 76 00 06 00 00 72 78 78 78 78 73 00 00 75 70 97 78 78 73
06 00 00 00 72 78 73 00 00 00 00 00 00 00 00 00 72 78 78 78 73 00 03 00 00 66 70 70 70 70 74 00 00 00 00 72 78 78 73
06 00 00 00 72 78 81 71 71 71 71 76 00 00 00 00 72 78 78 78 73 00 00 00 00 00 00 00 00 00 00 00 00 00 00 75 70 70 95
36 00 00 00 72 78 78 78 78 78 78 96 05 16 00 00 75 97 78 98 74 00 00 00 00 00 00 00 00 00 00 00 77 76 00 00 00 00 06
36 00 00 00 132 70 70 97 78 78 78 73 00 06 00 00 00 72 78 73 00 00 00 00 00 00 00 00 00 00 00 00 72 81 71 76 00 00 06
23 00 00 05 16 00 00 75 70 70 70 74 00 06 00 00 77 80 78 81 76 00 01 05 05 05 00 00 02 00 77 71 80 78 78 73 00 00 06
06 00 00 00 00 00 00 00 00 00 00 00 00 06 00 00 72 78 78 78 73 00 06 00 00 00 00 00 06 00 75 70 70 70 70 74 00 00 06
06 00 00 00 00 00 00 00 00 00 00 00 00 00 00 00 75 70 70 70 74 00 06 00 00 00 00 00 06 00 00 00 00 00 00 00 00 00 06
06 00 00 00 06 00 00 00 00 00 00 00 00 00 00 00 00 00 00 00 00 00 06 00 77 71 76 00 06 00 00 00 00 00 00 00 00 00 06
03 05 05 05 27 05 05 05 05 05 05 05 05 27 05 05 05 05 05 05 05 05 27 05 66 70 69 05 27 05 05 05 05 05 05 05 05 05 04