001 005 005 005 005 005 005 145 145 145 028 123 038 039 068 071 071 071 067 005 057 059 038 039 123 150 038 039 123 150 038 039 123 150 038 039 005 005 002
006 000 000 000 000 000 000 137 153 137 006 124 000 000 072 078 078 078 073 000 058 060 000 000 124 000 000 000 124 000 041 000 124 000 056 000 000 035 040
006 000 000 000 000 000 000 138 154 138 006 000 041 000 241 242 242 242 243 000 000 000 056 041 181 118 000 000 000 000 000 000 000 000 000 000 000 046 040
006 000 000 000 000 000 000 000 000 216 006 000 000 000 000 000 041 000 000 056 000 041 108 109 151 151 110 152 145 145 145 028 144 123 092 093 123 047 016
006 000 000 000 000 000 000 000 056 217 248 000 041 000 000 000 000 000 000 000 000 000 072 078 078 078 078 073 168 169 172 006 162 124 041 000 124 000 006
006 000 000 056 000 000 000 000 181 118 249 000 000 000 000 196 197 195 000 041 000 000 075 070 070 070 070 074 170 171 154 006 000 000 141 141 000 000 006
023 145 145 038 039 145 145 145 145 145 133 071 221 220 071 198 200 199 076 000 000 000 041 000 000 056 000 000 000 000 000 090 000 000 139 140 000 041 006
006 137 153 000 000 153 137 153 137 146 072 078 078 078 078 078 078 078 081 221 220 076 000 000 056 000 000 000 000 041 000 091 000 000 196 195 056 000 006
006 138 154 000 000 154 138 154 138 000 132 232 232 097 078 098 232 232 097 078 078 125 126 126 126 136 041 238 240 001 145 231 145 145 202 201 092 093 016
006 000 000 000 000 000 000 000 000 216 006 168 169 241 242 243 168 169 075 070 070 070 079 086 087 074 000 239 000 006 142 137 153 137 153 137 000 000 006
023 092 093 123 005 028 005 092 093 218 016 170 171 000 000 041 170 171 000 000 000 000 006 000 000 000 000 000 041 227 143 138 154 138 154 138 041 000 006
006 041 000 124 141 006 180 000 056 041 090 000 000 077 071 076 000 000 077 071 076 000 090 041 000 000 000 000 056 228 181 118 000 000 192 191 077 071 094
036 056 166 165 164 163 177 178 000 000 091 000 041 120 078 073 056 000 072 078 073 041 000 056 000 000 000 000 000 090 056 000 000 000 077 187 080 078 073
036 000 181 118 077 099 076 179 041 000 006 000 000 121 078 073 000 041 241 242 243 000 091 000 000 000 041 000 000 091 000 041 207 104 072 078 078 078 073
006 196 195 077 080 078 081 076 000 000 006 175 203 072 078 073 000 000 000 041 000 000 006 233 077 071 076 000 233 006 216 205 138 105 075 097 078 078 073
003 194 193 066 070 070 070 069 005 005 027 174 204 066 070 069 038 039 005 005 038 039 027 234 066 070 069 005 234 027 218 219 005 005 005 066 070 070 074