01 05 05 05 05 05 05 05 05 05 28 05 05 05 68 71 71 71 67 05 05 05 05 05 05 05 05 05 05 05 05 05 05 05 05 05 05 05 02
06 00 00 00 00 00 00 00 00 00 06 00 00 00 72 78 78 78 73 00 00 00 00 00 00 00 00 00 00 00 00 00 00 00 00 36 00 35 40
06 00 00 00 00 00 00 00 00 00 06 00 00 00 75 70 70 70 74 00 00 00 00 00 00 00 00 00 00 00 00 00 00 00 00 00 00 00 40
06 00 00 00 00 00 00 00 00 00 06 00 00 00 00 00 00 00 00 00 00 00 77 71 71 71 71 67 05 05 05 28 05 05 92 93 05 05 16
06 00 00 00 00 00 00 00 00 00 90 00 00 00 00 00 00 00 00 00 00 00 72 78 78 78 78 73 00 00 00 06 00 00 00 00 00 00 06
06 00 00 00 00 00 00 00 00 00 91 00 00 00 00 00 00 00 00 00 00 00 75 70 70 70 70 74 00 00 00 06 00 00 00 00 00 00 06
23 05 05 38 39 05 05 05 05 05 133 71 71 71 71 71 71 71 76 00 00 00 00 00 00 00 00 00 00 00 00 90 00 00 00 00 00 00 06
06 00 00 00 00 00 00 00 00 00 72 78 78 78 78 78 78 78 81 71 71 76 00 00 00 00 00 00 00 00 00 91 00 00 00 00 00 00 06
06 00 00 00 00 00 00 00 00 00 132 70 70 97 78 98 70 70 97 78 78 81 71 71 71 76 00 00 00 01 05 27 05 05 05 05 92 93 16
06 00 00 00 00 00 00 00 00 00 06 00 00 75 70 74 00 00 75 70 70 70 79 70 70 74 00 00 00 06 00 00 00 00 00 00 00 00 06
23 92 93 05 05 28 05 92 93 05 16 00 00 00 00 00 00 00 00 00 00 00 06 00 00 00 00 00 00 06 00 00 00 00 00 00 00 00 06
06 00 00 00 00 06 00 00 00 00 90 00 00 77 71 76 00 00 77 71 76 00 90 00 00 00 00 00 00 06 00 00 00 00 00 00 77 71 94
36 00 00 00 00 06 00 00 00 00 91 00 00 72 78 73 00 00 72 78 73 00 00 00 00 00 00 00 00 90 00 00 00 00 77 71 80 78 73
36 00 00 00 77 99 76 00 00 00 06 00 00 72 78 73 00 00 75 70 74 00 91 00 00 00 00 00 00 91 00 00 00 00 72 78 78 78 73
06 00 00 77 80 78 81 76 00 00 06 00 00 72 78 73 00 00 00 00 00 00 06 00 77 71 76 00 00 06 00 00 00 00 75 97 78 78 73
03 05 05 66 70 70 70 69 05 05 27 05 05 66 70 69 05 05 05 05 05 05 27 05 66 70 69 05 05 27 05 05 05 05 05 66 70 70 74