001 005 005 005 005 005 005 005 005 005 028 005 005 005 068 071 071 071 067 005 057 059 038 039 123 150 038 039 123 150 038 039 123 150 038 039 005 005 002
006 000 000 000 000 000 000 000 000 000 006 000 000 000 072 078 078 078 073 000 058 060 000 000 124 000 000 000 124 000 000 000 124 000 000 036 000 035 040
006 000 000 000 000 000 000 000 000 000 006 000 000 000 075 070 070 070 074 000 000 000 000 000 181 118 000 000 000 000 000 000 000 000 000 000 000 046 040
006 000 000 000 000 000 000 000 000 000 006 000 000 000 000 000 000 000 000 000 000 000 108 109 151 151 110 152 145 145 145 028 144 123 092 093 123 047 016
006 000 000 000 000 000 000 000 000 000 090 000 000 000 000 000 000 000 000 000 000 000 072 078 078 078 078 073 168 169 172 006 162 124 000 000 124 000 006
006 000 000 000 000 000 000 000 000 000 091 000 000 000 000 196 197 195 000 000 000 000 075 070 070 070 070 074 170 171 154 006 000 000 141 141 000 000 006
023 145 145 038 039 145 145 145 145 145 133 071 071 071 071 198 200 199 076 000 000 000 000 000 000 000 000 000 000 000 000 090 000 000 139 140 000 000 006
006 137 153 000 000 153 137 153 137 146 072 078 078 078 078 078 078 078 081 071 071 076 000 000 000 000 000 000 000 000 000 091 000 000 196 195 000 000 006
006 138 154 000 000 154 138 154 138 000 132 145 145 097 078 098 145 145 097 078 078 125 126 126 126 136 000 000 000 001 145 145 145 145 202 201 092 093 016
006 000 000 000 000 000 000 000 000 000 006 168 169 075 070 074 168 169 075 070 070 070 079 070 070 074 000 000 000 006 142 137 153 137 153 137 000 000 006
023 092 093 123 005 028 005 092 093 005 016 170 171 000 000 000 170 171 000 000 000 000 006 000 000 000 000 000 000 006 143 138 154 138 154 138 000 000 006
006 000 000 124 141 006 180 000 000 000 090 000 000 077 071 076 000 000 077 071 076 000 090 000 000 000 000 000 000 006 000 000 000 000 192 191 077 071 094
036 000 166 165 164 163 177 178 000 000 091 000 000 072 078 073 000 000 072 078 073 000 000 000 000 000 000 000 000 090 000 000 000 161 160 187 080 078 073
036 000 181 118 077 099 076 179 000 000 006 000 000 072 078 073 000 000 075 070 074 000 091 000 000 000 000 000 000 091 000 000 000 159 158 078 078 078 073
006 196 195 077 080 078 081 076 000 000 006 175 203 072 078 073 000 000 000 000 000 000 006 000 077 071 076 000 000 006 000 000 000 157 156 097 078 078 073
003 194 193 066 070 070 070 069 005 005 027 174 204 066 070 069 005 005 005 005 005 005 027 005 066 070 069 005 005 027 005 005 005 005 005 066 070 070 074