01 05 05 05 05 05 05 05 05 28 05 05 05 05 05 28 05 05 05 05 28 05 05 05 05 05 05 05 05 05 05 05 05 05 05 05 05 05 02
06 00 00 00 00 00 00 00 00 06 00 00 00 00 00 06 00 00 00 00 06 00 00 00 00 00 00 00 00 00 00 00 00 00 00 00 00 00 06
06 00 00 00 00 00 00 00 00 06 00 00 00 00 00 06 00 00 00 00 06 00 00 00 00 00 00 00 00 00 00 00 00 00 00 00 00 00 00
06 00 00 00 00 00 00 00 00 06 00 00 00 00 00 03 05 05 05 05 04 00 00 00 00 00 00 00 00 00 00 00 00 00 00 00 00 00 00
06 00 00 00 00 00 00 00 00 00 00 00 00 00 00 00 00 00 00 00 00 00 00 00 00 00 00 00 00 00 00 00 00 00 00 00 00 00 06
06 00 00 00 00 00 00 00 00 00 00 00 00 00 00 00 00 00 00 00 00 00 00 00 00 00 00 00 00 00 00 00 00 00 00 00 00 00 06
06 00 00 00 00 00 00 00 00 06 00 00 00 00 00 00 00 00 00 00 00 00 00 00 00 00 00 00 00 00 00 00 00 00 00 00 00 00 06
06 00 00 00 00 00 00 00 00 06 00 00 00 00 00 00 00 00 00 00 00 00 00 00 00 00 00 00 00 00 00 00 00 00 00 00 00 00 06
06 00 00 00 05 05 28 05 05 04 00 00 00 00 00 00 00 00 00 05 05 05 05 28 05 05 05 28 05 05 05 05 05 05 05 05 05 05 16
06 00 00 00 00 00 06 00 00 00 00 00 00 00 00 00 00 00 00 00 00 00 00 06 00 00 00 06 00 00 00 00 00 00 00 00 00 00 06
06 00 00 00 00 00 06 00 00 00 00 00 00 00 00 00 00 00 00 00 00 00 00 06 00 00 00 06 00 00 00 00 00 00 00 00 00 00 06
06 00 00 00 00 00 06 00 00 00 00 00 00 00 00 00 00 00 00 00 01 05 05 04 00 00 00 06 00 00 00 00 00 00 00 00 00 00 06
06 00 00 00 00 00 06 00 00 00 00 00 00 00 00 00 00 00 00 00 06 00 00 00 00 00 00 00 00 00 00 00 00 00 00 00 00 00 06
23 05 05 05 05 05 27 05 28 05 05 05 00 00 00 00 00 00 00 00 06 00 00 00 00 00 00 00 00 00 00 00 00 00 00 00 00 00 06
06 00 00 00 00 00 00 00 06 00 00 00 00 00 00 00 00 00 00 00 06 00 00 00 00 00 00 06 00 00 00 00 00 00 00 00 00 00 06
06 00 00 00 00 00 00 00 06 00 00 00 00 00 00 00 00 00 00 00 03 05 05 05 05 05 05 27 05 05 28 05 05 00 00 00 00 00 06
06 00 00 00 00 00 00 00 06 00 00 00 00 00 00 00 00 00 00 00 00 00 00 00 00 00 00 00 00 00 06 00 00 00 00 00 00 00 06
06 00 00 00 00 00 00 00 06 00 00 00 00 00 00 00 00 00 00 00 00 00 00 00 00 00 00 00 00 00 06 00 00 00 00 00 00 00 06
06 00 00 00 00 00 00 00 06 00 00 00 00 00 00 00 00 00 00 00 00 00 00 00 00 00 00 00 00 00 06 00 00 00 00 00 00 00 06
06 00 00 00 00 00 00 00 00 00 00 00 00 00 00 00 00 00 00 00 00 00 00 00 00 00 00 00 00 00 00 00 00 00 00 00 00 00 06
00 00 00 00 00 00 00 00 00 00 00 00 00 00 00 00 00 00 00 00 00 00 00 00 00 00 00 00 00 00 00 00 00 00 00 00 00 00 06
00 00 00 00 00 00 00 00 00 00 00 00 00 00 00 00 00 00 00 00 00 00 00 00 00 00 00 00 00 00 06 00 00 00 00 00 00 00 06
06 00 00 00 00 00 00 00 00 00 00 00 00 00 00 00 00 00 00 00 00 00 00 00 00 00 00 00 00 00 06 00 00 00 00 00 00 00 06
03 05 05 05 05 05 05 05 05 05 05 05 05 05 05 05 05 05 05 05 05 05 05 05 05 05 05 05 05 05 27 05 05 05 05 05 05 05 04