01 05 05 05 05 05 05 05 05 05 28 05 05 05 68 71 71 71 67 05 57 59 38 39 123 150 38 39 123 150 38 39 123 150 38 39 05 05 02
06 00 00 00 00 00 00 00 00 00 06 00 00 00 72 78 78 78 73 00 58 60 00 00 124 00 00 00 124 00 00 00 124 00 00 36 00 35 40
06 00 00 00 00 00 00 00 00 00 06 00 00 00 75 70 70 70 74 00 00 00 00 00 00 00 00 00 00 00 00 00 00 00 00 00 00 46 40
06 00 00 00 00 00 00 00 00 00 06 00 00 00 00 00 00 00 00 00 00 00 108 109 151 151 110 152 145 145 145 28 144 123 92 93 123 47 16
06 00 00 00 00 00 00 00 00 00 90 00 00 00 00 00 00 00 00 00 00 00 72 78 78 78 78 73 168 169 172 06 162 124 00 00 124 00 06
06 00 00 00 00 00 00 00 00 00 91 00 00 00 00 00 00 00 00 00 00 00 75 70 70 70 70 74 170 171 154 06 00 00 141 141 00 00 06
23 145 145 38 39 145 145 145 145 145 133 71 71 71 71 71 71 71 76 00 00 00 00 00 00 00 00 00 00 00 00 90 00 00 139 140 00 00 06
06 137 153 00 00 153 137 153 137 146 72 78 78 78 78 78 78 78 81 71 71 76 00 00 00 00 00 00 00 00 00 91 00 00 00 00 00 00 06
06 138 154 00 00 154 138 154 138 00 132 145 145 97 78 98 145 145 97 78 78 125 126 126 126 136 00 00 00 01 145 145 145 145 145 145 92 93 16
06 00 00 00 00 00 00 00 00 00 06 168 169 75 70 74 168 169 75 70 70 70 79 70 70 74 00 00 00 06 142 137 153 137 153 137 00 00 06
23 92 93 123 05 28 05 92 93 05 16 170 171 00 00 00 170 171 00 00 00 00 06 00 00 00 00 00 00 06 143 138 154 138 154 138 00 00 06
06 00 00 124 141 06 00 00 00 00 90 00 00 77 71 76 00 00 77 71 76 00 90 00 00 00 00 00 00 06 00 00 00 00 00 46 77 71 94
36 00 166 165 164 163 00 00 00 00 91 00 00 72 78 73 00 00 72 78 73 00 00 00 00 00 00 00 00 90 00 00 00 161 160 47 80 78 73
36 00 00 00 77 99 76 00 00 00 06 00 00 72 78 73 00 00 75 70 74 00 91 00 00 00 00 00 00 91 00 00 00 159 158 78 78 78 73
06 00 00 77 80 78 81 76 00 00 06 00 00 72 78 73 00 00 00 00 00 00 06 00 77 71 76 00 00 06 00 00 00 157 156 97 78 78 73
03 05 05 66 70 70 70 69 05 05 27 05 05 66 70 69 05 05 05 05 05 05 27 05 66 70 69 05 05 27 05 05 05 05 05 66 70 70 74
