01 05 05 05 05 05 28 05 05 05 28 38 39 28 05 28 38 39 28 05 28 05 05 05 28 05 28 38 39 28 05 28 38 39 28 05 05 05 02
06 00 00 33 00 00 06 00 00 00 27 00 00 27 00 27 00 00 27 00 06 00 00 00 06 00 27 00 00 27 00 27 00 00 27 00 00 00 06
06 00 00 34 35 00 06 00 00 00 00 00 00 00 00 00 00 00 00 00 03 05 05 05 04 00 00 00 00 00 00 00 00 00 00 00 00 00 06
06 00 00 00 00 00 00 00 00 00 00 00 00 00 00 00 00 00 00 00 00 00 00 00 00 00 00 00 00 00 00 00 00 00 00 00 00 00 06
06 00 00 00 00 00 41 00 00 00 00 00 00 00 00 00 00 00 00 00 00 00 00 00 00 00 00 00 00 00 00 00 00 00 00 00 00 00 06
23 05 05 05 05 05 16 00 00 00 01 05 05 02 00 00 00 01 05 02 00 00 00 00 00 01 05 05 05 28 05 05 38 39 05 05 05 05 16
06 00 00 00 00 00 06 00 00 00 06 00 00 03 05 05 05 04 00 06 00 00 00 00 00 06 00 00 00 06 00 00 00 00 00 00 00 00 06
06 00 00 00 00 00 00 00 00 00 06 00 00 00 00 00 00 00 00 06 00 00 01 05 05 04 00 00 00 06 00 00 00 00 00 00 00 00 06
06 00 00 00 00 00 00 00 00 00 06 00 00 00 00 00 00 00 00 06 00 00 06 00 00 00 00 00 00 06 00 00 00 00 00 00 00 00 06
06 00 00 00 00 00 23 38 39 05 27 05 05 05 28 05 05 05 05 16 00 00 23 05 05 38 39 05 05 15 05 05 05 05 05 38 39 05 16
23 38 39 05 05 05 16 00 00 00 00 00 00 00 06 00 00 00 00 00 00 00 00 00 00 00 00 00 00 00 00 00 00 00 00 00 00 00 06
06 00 00 00 00 00 06 00 00 00 00 00 00 00 06 00 00 00 00 00 00 00 00 00 00 00 00 00 00 00 00 00 00 00 00 00 00 00 06
06 00 00 00 00 00 00 00 00 01 38 39 05 05 27 02 00 00 00 00 00 00 00 00 00 00 00 00 00 00 00 00 00 00 00 00 00 00 36
06 00 00 00 00 00 00 00 00 06 00 00 00 00 00 03 05 05 05 02 00 00 01 05 05 05 05 05 05 05 05 02 00 00 00 00 00 00 36
06 00 00 00 00 00 06 00 00 06 00 00 00 00 00 00 00 00 00 06 00 00 06 00 00 00 00 00 00 00 00 06 00 00 00 00 00 00 06
03 05 05 05 05 05 05 05 05 27 05 05 05 05 05 05 05 05 05 27 05 05 27 05 05 05 05 05 05 05 05 27 05 05 05 05 05 05 04
