001 145 145 145 145 145 028 005 057 059 123 038 039 057 059 038 039 123 057 059 068 071 071 071 067 005 057 059 005 038 039 005 038 039 005 057 059 005 002
006 147 189 188 147 147 064 065 058 060 124 000 000 058 060 000 000 124 058 060 072 078 078 078 073 000 058 060 000 000 000 000 000 000 000 058 060 000 006
006 000 143 138 035 000 062 063 000 000 100 104 106 119 000 000 055 103 104 116 075 127 128 129 074 000 000 000 000 000 000 000 000 000 000 000 000 000 006
006 000 192 191 175 203 061 000 041 102 101 105 107 117 118 000 102 101 105 115 000 000 000 000 000 000 000 000 000 000 000 000 000 000 000 000 000 000 006
023 005 190 187 174 204 016 000 000 000 000 000 000 000 000 000 000 000 000 000 000 000 000 000 000 000 000 116 000 000 000 000 000 000 000 000 000 000 006
006 000 000 000 000 000 090 000 000 000 108 109 110 111 000 000 000 112 113 114 000 000 000 141 115 077 071 071 071 067 005 005 092 093 005 005 005 005 016
006 000 000 000 000 000 091 000 000 000 120 078 078 125 126 126 126 122 078 073 000 000 000 139 140 072 078 078 078 073 000 000 000 000 000 000 000 000 006
006 000 000 000 000 000 006 000 000 000 121 078 078 078 078 078 078 078 078 073 000 000 077 071 071 080 078 078 078 081 071 076 000 000 000 000 000 000 006
006 000 000 000 000 077 094 000 000 000 072 078 078 078 078 078 078 078 078 073 000 000 072 078 078 078 078 078 078 078 078 081 071 076 000 000 000 000 006
006 000 000 000 077 080 096 038 039 123 066 070 070 070 079 070 070 086 087 074 000 000 075 070 070 086 087 070 097 078 078 078 078 096 005 038 039 005 016
023 092 093 005 066 097 073 000 000 124 000 000 000 000 090 000 000 000 000 000 000 000 000 000 000 000 000 000 075 070 070 070 070 074 000 000 000 000 120
006 000 000 000 000 075 095 000 000 000 000 000 000 000 091 000 000 000 000 000 000 000 000 000 000 000 000 000 000 000 000 000 000 000 000 000 000 000 121
006 000 000 000 000 000 090 000 000 077 088 089 071 071 099 076 000 000 000 000 000 000 000 000 000 000 000 000 000 000 000 000 000 000 000 000 000 000 036
006 000 000 000 000 000 091 000 000 072 078 078 078 078 078 081 071 071 071 076 000 000 077 071 071 071 071 071 071 071 071 076 182 182 182 182 000 000 036
006 000 000 000 000 046 006 000 000 072 078 078 078 078 078 078 078 078 078 081 071 071 080 078 078 078 078 078 078 078 078 073 168 169 186 147 000 000 006
003 005 005 005 005 047 027 005 005 066 070 070 070 070 070 070 070 070 070 070 070 070 070 070 070 070 070 070 070 070 070 069 183 184 185 005 005 005 004