001 145 145 145 145 145 028 005 057 059 123 038 039 057 059 038 039 123 057 059 068 071 071 071 067 005 057 059 005 038 039 005 038 039 005 057 059 005 002
006 147 189 188 147 147 064 065 058 060 124 000 000 058 060 000 000 124 058 060 072 078 078 078 073 000 058 060 000 000 000 000 000 000 000 058 060 000 006
006 000 143 138 035 215 062 063 000 205 207 104 106 119 000 000 205 207 104 116 075 127 128 129 074 000 000 205 207 104 106 000 205 207 104 000 000 000 006
006 036 192 191 175 203 061 000 000 206 138 105 107 117 118 000 206 138 105 115 000 000 000 000 000 000 000 206 138 105 107 000 206 138 105 000 000 000 006
023 005 190 187 174 204 016 000 000 000 000 000 000 000 000 000 000 000 000 000 000 000 000 000 000 000 000 000 000 000 000 000 000 000 000 000 000 000 006
006 000 000 000 000 000 090 000 000 000 108 109 110 111 000 000 000 112 113 114 000 000 000 209 208 077 221 220 071 067 005 005 092 093 145 145 145 145 016
006 205 209 210 208 216 091 000 000 000 120 078 078 125 126 126 126 122 078 073 000 000 000 196 195 072 078 078 078 073 000 000 000 000 142 137 153 137 006
006 206 181 118 000 217 006 000 000 000 121 078 078 078 078 078 078 078 078 073 000 000 077 229 230 080 078 078 078 081 071 076 000 000 143 138 154 138 006
006 000 213 212 211 077 094 000 000 000 072 078 078 078 078 078 078 078 078 073 000 000 072 078 078 078 078 078 078 078 078 081 071 076 000 000 000 216 006
006 000 000 000 077 080 096 038 039 123 066 070 070 070 079 070 226 086 087 074 000 000 075 070 226 086 087 070 097 078 078 078 078 096 005 038 039 218 016
023 092 093 123 066 097 073 000 000 124 000 000 000 000 090 000 124 000 000 000 000 000 000 000 124 000 000 000 075 070 070 070 070 074 181 118 000 000 227
006 000 000 124 000 075 095 000 000 000 000 000 000 000 091 000 000 000 000 000 000 000 000 000 000 000 000 000 000 000 000 000 000 000 000 000 000 000 228
006 000 000 000 000 000 090 000 000 077 088 089 224 071 099 076 000 000 000 000 000 000 000 000 000 000 000 000 000 000 000 000 000 000 000 000 000 000 036
006 182 182 182 000 000 091 000 000 072 078 078 223 078 078 081 071 221 220 076 175 203 077 221 220 224 222 221 220 224 222 076 182 182 182 182 000 000 036
006 168 169 235 000 046 006 175 203 072 078 078 078 078 078 078 078 078 078 081 236 237 080 078 078 223 078 078 078 223 078 073 168 169 235 147 000 000 006
003 183 184 185 005 047 027 174 204 066 070 070 070 070 070 070 070 070 070 070 070 070 070 070 070 070 070 070 070 070 070 069 183 184 185 005 005 005 004
