01 05 42 33 05 44 28 05 57 59 05 38 39 57 59 38 39 05 57 59 68 71 71 71 67 05 57 59 05 38 39 05 38 39 05 57 59 05 02
06 00 43 34 35 45 64 65 58 60 00 00 00 58 60 00 00 00 58 60 72 78 78 78 73 00 58 60 00 00 00 00 00 00 00 58 60 00 06
06 00 00 55 56 52 62 63 00 00 100 104 106 00 00 00 55 103 104 116 75 70 70 70 74 00 00 00 00 00 00 00 00 00 00 00 00 00 06
06 00 56 48 46 50 61 00 41 102 101 105 107 00 00 00 102 101 105 115 00 00 00 00 00 00 00 00 00 00 00 00 00 00 00 00 00 00 06
23 05 05 49 47 51 16 00 00 00 00 00 00 00 00 00 00 00 00 00 00 00 00 00 00 00 00 00 00 00 00 00 00 00 00 00 00 00 06
06 00 00 00 00 00 61 55 00 00 108 109 110 111 00 00 00 112 113 114 00 00 00 55 00 77 71 71 71 67 05 05 92 93 05 05 05 05 16
06 00 00 00 00 00 64 65 00 00 72 78 78 81 71 71 71 80 78 73 00 00 00 83 85 72 78 78 78 73 00 00 00 00 00 00 00 00 06
06 00 00 00 00 00 62 63 00 00 72 78 78 78 78 78 78 78 78 73 00 00 77 82 84 80 78 78 78 81 71 76 00 00 00 00 00 00 06
06 00 00 00 00 77 94 00 00 00 72 78 78 78 78 78 78 78 78 73 00 00 72 78 78 78 78 78 78 78 78 81 71 76 00 00 00 00 06
06 00 00 00 77 80 96 38 39 05 66 70 70 70 79 70 70 86 87 74 00 00 75 70 70 86 87 70 97 78 78 78 78 96 05 38 39 05 16
23 92 93 05 66 97 73 00 00 00 00 00 00 00 90 00 00 00 00 00 00 00 00 00 00 00 00 00 75 70 70 70 70 74 00 00 00 00 06
06 00 00 00 00 75 95 00 00 00 00 00 00 00 91 00 00 00 00 00 00 00 00 00 00 00 00 00 00 00 00 00 00 00 00 00 00 00 06
06 00 00 00 00 00 90 00 00 77 88 89 71 71 99 76 00 00 00 00 00 00 00 00 00 00 00 00 00 00 00 00 00 00 00 00 00 00 36
06 00 00 00 00 00 91 00 00 72 78 78 78 78 78 81 71 71 71 76 00 00 77 71 71 71 71 71 71 71 71 76 00 00 00 00 00 00 36
06 00 00 00 00 46 06 00 00 72 78 78 78 78 78 78 78 78 78 73 00 00 72 78 78 78 78 78 78 78 78 73 00 00 00 00 00 00 06
03 05 05 05 05 47 27 05 05 66 70 70 70 70 70 70 70 70 70 69 05 05 66 70 70 70 70 70 70 70 70 69 05 05 05 05 05 05 04