01 05 44 31 05 47 28 05 05 05 28 40 41 28 05 28 38 39 28 05 28 05 05 05 28 05 28 38 39 28 05 28 38 39 28 05 05 05 02
06 00 45 32 35 48 06 00 00 00 27 42 43 27 00 27 00 00 27 00 06 00 00 00 06 00 27 00 00 27 00 27 00 00 27 00 00 00 06
06 49 00 00 51 46 06 00 00 00 00 00 00 00 00 00 00 00 00 00 03 05 05 05 04 00 00 00 00 00 00 00 00 00 00 00 00 00 06
06 00 00 00 52 54 00 00 00 00 00 00 00 00 00 00 00 00 00 00 00 00 00 00 00 00 00 00 00 00 00 00 00 00 00 00 00 00 06
23 05 05 05 53 55 16 00 00 00 00 00 00 00 00 00 00 00 00 00 00 00 00 00 00 00 00 00 00 00 00 00 00 00 00 00 00 00 06
06 00 00 00 00 00 06 00 00 00 01 05 02 00 00 00 01 05 05 02 00 00 00 00 00 01 05 05 05 28 05 05 38 39 05 05 05 05 16
06 00 00 00 00 00 06 00 00 00 06 00 03 05 05 05 04 00 00 06 00 00 00 00 00 06 00 00 00 06 00 00 00 00 00 00 00 00 06
06 00 00 00 00 00 00 00 00 00 06 00 00 00 00 00 00 00 00 06 00 00 01 05 05 04 00 00 00 06 00 00 00 00 00 00 00 00 06
06 00 00 00 00 00 00 00 00 00 06 00 00 00 00 00 00 00 00 06 00 00 06 00 00 00 00 00 00 06 00 00 00 00 00 00 00 00 06
06 00 00 00 00 00 23 38 39 05 27 05 05 05 28 05 05 05 05 16 00 00 23 05 05 38 39 05 05 15 05 05 05 05 05 38 39 05 16
23 38 39 05 05 05 16 00 00 00 00 00 00 00 06 00 00 00 00 00 00 00 00 00 00 00 00 00 00 00 00 00 00 00 00 00 00 00 06
06 00 00 00 00 00 06 00 00 00 00 00 00 00 06 00 00 00 00 00 00 00 00 00 00 00 00 00 00 00 00 00 00 00 00 00 00 00 06
06 00 00 00 00 00 00 00 00 01 38 39 05 05 27 02 00 00 00 00 00 00 00 00 00 00 00 00 00 00 00 00 00 00 00 00 00 00 36
06 00 00 00 00 00 00 00 00 06 00 00 00 00 00 03 05 05 05 02 00 00 01 05 05 05 05 05 05 05 05 02 00 00 00 00 00 00 36
06 00 00 00 00 00 06 00 00 06 00 00 00 00 00 00 00 00 00 06 00 00 06 00 00 00 00 00 00 00 00 06 00 00 00 00 00 00 06
03 05 05 05 05 05 05 05 05 27 05 05 05 05 05 05 05 05 05 27 05 05 27 05 05 05 05 05 05 05 05 27 05 05 05 05 05 05 04